####################
#           # C    #
#    S      #      #
#           #      #
#                  #
#     ###          #
#                  #
#   ############   #
#                  #
#                  #
# C                #
#      #######  ####
#                  #
#       ##       C #
#                  #
#                  #
#############      #
#                  #
# X                #
####################
