####################
#  C        # C X  #
#                  #
#     E     #      #
#           ########
#     ###          #
#             #    #
#   ############   #
#    #             #
#    #      E      #
#    #             #
#      #######  ####
#       ##         #
#   #   ##       C #
#   ####  ##       #
#                  #
#############      #
# C    #       S   #
#   #              #
####################
